X     XXXXX
X XX  XX  X
XSX X  X XX
XX X X XX  
 F XXX XX X
          X
XXXXXXXXXXX