XXXXXXXXXXXXXXXXXXXXXXXXXXXXXXXXX
X S                             X
XX XXXXXXXXXXXXXXX  F           X
X                X              X
X                X              X
XXXXXXXXXXXXXXXXXXXXXXXXXXXXXXXXX