XXXXXXXXXXXXXXXXXXXXXXX
X F XXX   X XXX X  XX X
X XX  X  XXX  X XXXX XX
X  XXX XXX X          X
XX  X       XXX       X
X X      XX           X
X XXXXXXXXX    XX     X
X           XX     S  X
X XX X XXXXX       XX X
XXXXXXXXXXXXXXXXXXXXXXX